20 10
####################
#########         <#
#         ##########
### ### # #        #
#     # # #### #####
# #   # #          #
# # ###   ######## #
# #     ###        #
#   ### #@         #
####################