5 5
#####
#<  #
### #
#@  #
#####
