30 20
##############################
#########         <          #
#        #####################
### ### # #        #     ##  #
#     # # #### #####   ##### #
# #   # #          #  ### ## #
# # ###   ######## # # #  #  #
# #     ###        # # # ## ##
#   ### #@         # #       #
#   ############## # #       #
#   #              #         #
#   ###   ##  ##  #####  # ###
###   ##           ### # #  ##
###  ##########  ####       ##
#       #######  ####       ##
#      ########  ####       ##
#                ####     ####
#                      #######
#   ####     ###    ##########
##############################