5 5
#####
#<  #
#####
#@  #
#####
